????????????????????????????????
?00000000000000-000000000000000?
?001100000000000000000000011000?
?000000000000000000000000000000?
?000000000100000000000000000000?
?000000000100000000000000000000?
?000000000000010000000000000000?
?000000000000000000000000100000?
?000000000000000000001000000000?
?000000010000000000000000000000?
?000000000000000000000000000000?
?000000000000000000111100000000?
?000000000000000000000000000000?
?000000011000000000000000000000?
?000000000000000000000000000000?
?000000000000000000000000000000?
?000000000000000000000000000000?
?000000000000000000000000000000?
?000000000000000001111111111111?
?000000000000000000000000000000?
?0000000000*0000000000000000000?
?001100000000000000000000011000?
?000000000000000000000000000000?
????????????????????????????????